111111111111111
100PC00000000E1
1000000000E0001
111111111111111
